"filename", "language", "JSON", "CMake", "C++", "Markdown", "TypeScript", "comment", "blank", "total"
"c:\Users\linC\app\programming\C++ Project\HyperChat\Benchmark\BenchmarkLog.hpp", "C++", 0, 0, 39, 0, 0, 0, 4, 43
"c:\Users\linC\app\programming\C++ Project\HyperChat\Benchmark\CMakeLists.txt", "CMake", 0, 4, 0, 0, 0, 0, 2, 6
"c:\Users\linC\app\programming\C++ Project\HyperChat\Benchmark\RunBenchmark.cpp", "C++", 0, 0, 20, 0, 0, 0, 1, 21
"c:\Users\linC\app\programming\C++ Project\HyperChat\CMakeLists.txt", "CMake", 0, 15, 0, 0, 0, 0, 5, 20
"c:\Users\linC\app\programming\C++ Project\HyperChat\CMakePresets.json", "JSON", 22, 0, 0, 0, 0, 0, 1, 23
"c:\Users\linC\app\programming\C++ Project\HyperChat\ChatClient\CMakeLists.txt", "CMake", 0, 74, 0, 0, 0, 0, 14, 88
"c:\Users\linC\app\programming\C++ Project\HyperChat\ChatClient\ChatClient_zh_CN.ts", "TypeScript", 0, 0, 0, 0, 3, 0, 1, 4
"c:\Users\linC\app\programming\C++ Project\HyperChat\ChatClient\chatclient.cpp", "C++", 0, 0, 63, 0, 0, 0, 3, 66
"c:\Users\linC\app\programming\C++ Project\HyperChat\ChatClient\chatclient.h", "C++", 0, 0, 33, 0, 0, 0, 7, 40
"c:\Users\linC\app\programming\C++ Project\HyperChat\ChatClient\chatservicestub.cpp", "C++", 0, 0, 4, 0, 0, 0, 3, 7
"c:\Users\linC\app\programming\C++ Project\HyperChat\ChatClient\chatservicestub.h", "C++", 0, 0, 9, 0, 0, 0, 4, 13
"c:\Users\linC\app\programming\C++ Project\HyperChat\ChatClient\main.cpp", "C++", 0, 0, 30, 0, 0, 12, 5, 47
"c:\Users\linC\app\programming\C++ Project\HyperChat\ChatClient\mainwindow.cpp", "C++", 0, 0, 14, 0, 0, 0, 3, 17
"c:\Users\linC\app\programming\C++ Project\HyperChat\ChatClient\mainwindow.h", "C++", 0, 0, 16, 0, 0, 0, 6, 22
"c:\Users\linC\app\programming\C++ Project\HyperChat\ChatClient\protocolresponsehandler.cpp", "C++", 0, 0, 4, 0, 0, 0, 3, 7
"c:\Users\linC\app\programming\C++ Project\HyperChat\ChatClient\protocolresponsehandler.h", "C++", 0, 0, 9, 0, 0, 0, 4, 13
"c:\Users\linC\app\programming\C++ Project\HyperChat\ChatServer\CmakeLists.txt", "CMake", 0, 12, 0, 0, 0, 0, 2, 14
"c:\Users\linC\app\programming\C++ Project\HyperChat\ChatServer\RunServer.cpp", "C++", 0, 0, 44, 0, 0, 0, 3, 47
"c:\Users\linC\app\programming\C++ Project\HyperChat\ChatServer\include\AsyncTcpServer.h", "C++", 0, 0, 33, 0, 0, 0, 6, 39
"c:\Users\linC\app\programming\C++ Project\HyperChat\ChatServer\include\ChatServer.h", "C++", 0, 0, 30, 0, 0, 0, 5, 35
"c:\Users\linC\app\programming\C++ Project\HyperChat\ChatServer\include\ChatService.h", "C++", 0, 0, 47, 0, 0, 0, 9, 56
"c:\Users\linC\app\programming\C++ Project\HyperChat\ChatServer\include\IoContextPool.h", "C++", 0, 0, 24, 0, 0, 0, 4, 28
"c:\Users\linC\app\programming\C++ Project\HyperChat\ChatServer\include\PO.hpp", "C++", 0, 0, 14, 0, 0, 0, 3, 17
"c:\Users\linC\app\programming\C++ Project\HyperChat\ChatServer\include\SQLExecuser.h", "C++", 0, 0, 15, 0, 0, 0, 7, 22
"c:\Users\linC\app\programming\C++ Project\HyperChat\ChatServer\include\SQLiteConnectionPool.h", "C++", 0, 0, 16, 0, 0, 0, 4, 20
"c:\Users\linC\app\programming\C++ Project\HyperChat\ChatServer\src\AsyncTcpServer.cpp", "C++", 0, 0, 94, 0, 0, 0, 9, 103
"c:\Users\linC\app\programming\C++ Project\HyperChat\ChatServer\src\ChatServer.cpp", "C++", 0, 0, 60, 0, 0, 1, 7, 68
"c:\Users\linC\app\programming\C++ Project\HyperChat\ChatServer\src\ChatService.cpp", "C++", 0, 0, 77, 0, 0, 5, 7, 89
"c:\Users\linC\app\programming\C++ Project\HyperChat\ChatServer\src\IoContextPool.cpp", "C++", 0, 0, 49, 0, 0, 0, 4, 53
"c:\Users\linC\app\programming\C++ Project\HyperChat\ChatServer\src\SQLExecuser.cpp", "C++", 0, 0, 66, 0, 0, 0, 8, 74
"c:\Users\linC\app\programming\C++ Project\HyperChat\ChatServer\src\SQLiteConnectionPool.cpp", "C++", 0, 0, 23, 0, 0, 0, 3, 26
"c:\Users\linC\app\programming\C++ Project\HyperChat\Common\CMakeLists.txt", "CMake", 0, 12, 0, 0, 0, 0, 1, 13
"c:\Users\linC\app\programming\C++ Project\HyperChat\Common\include\Connection.h", "C++", 0, 0, 30, 0, 0, 0, 7, 37
"c:\Users\linC\app\programming\C++ Project\HyperChat\Common\include\Dto.hpp", "C++", 0, 0, 43, 0, 0, 0, 10, 53
"c:\Users\linC\app\programming\C++ Project\HyperChat\Common\include\Logger.h", "C++", 0, 0, 147, 0, 0, 0, 22, 169
"c:\Users\linC\app\programming\C++ Project\HyperChat\Common\include\Protocol.h", "C++", 0, 0, 57, 0, 0, 9, 15, 81
"c:\Users\linC\app\programming\C++ Project\HyperChat\Common\include\Semaphore.h", "C++", 0, 0, 35, 0, 0, 0, 10, 45
"c:\Users\linC\app\programming\C++ Project\HyperChat\Common\include\Serializer.hpp", "C++", 0, 0, 217, 0, 0, 0, 30, 247
"c:\Users\linC\app\programming\C++ Project\HyperChat\Common\include\SpinLock.h", "C++", 0, 0, 14, 0, 0, 0, 5, 19
"c:\Users\linC\app\programming\C++ Project\HyperChat\Common\include\ThreadPool.h", "C++", 0, 0, 41, 0, 0, 0, 8, 49
"c:\Users\linC\app\programming\C++ Project\HyperChat\Common\include\Timestamp.h", "C++", 0, 0, 13, 0, 0, 0, 4, 17
"c:\Users\linC\app\programming\C++ Project\HyperChat\Common\include\UncopybleAndUnmovable.h", "C++", 0, 0, 11, 0, 0, 0, 2, 13
"c:\Users\linC\app\programming\C++ Project\HyperChat\Common\include\utils\IdGenerator.hpp", "C++", 0, 0, 8, 0, 0, 0, 1, 9
"c:\Users\linC\app\programming\C++ Project\HyperChat\Common\src\Connection.cpp", "C++", 0, 0, 105, 0, 0, 0, 7, 112
"c:\Users\linC\app\programming\C++ Project\HyperChat\Common\src\Logger.cpp", "C++", 0, 0, 198, 0, 0, 0, 28, 226
"c:\Users\linC\app\programming\C++ Project\HyperChat\Common\src\Protocol.cpp", "C++", 0, 0, 216, 0, 0, 0, 34, 250
"c:\Users\linC\app\programming\C++ Project\HyperChat\Common\src\Semaphore.cpp", "C++", 0, 0, 85, 0, 0, 0, 7, 92
"c:\Users\linC\app\programming\C++ Project\HyperChat\Common\src\Spinlock.cpp", "C++", 0, 0, 11, 0, 0, 1, 3, 15
"c:\Users\linC\app\programming\C++ Project\HyperChat\Common\src\ThreadPool.cpp", "C++", 0, 0, 45, 0, 0, 0, 6, 51
"c:\Users\linC\app\programming\C++ Project\HyperChat\Common\src\Timestamp.cpp", "C++", 0, 0, 32, 0, 0, 0, 7, 39
"c:\Users\linC\app\programming\C++ Project\HyperChat\README.md", "Markdown", 0, 0, 0, 42, 0, 0, 13, 55
"c:\Users\linC\app\programming\C++ Project\HyperChat\UnitTest\CMakeLists.txt", "CMake", 0, 6, 0, 0, 0, 0, 4, 10
"c:\Users\linC\app\programming\C++ Project\HyperChat\UnitTest\RunTest.cpp", "C++", 0, 0, 15, 0, 0, 0, 1, 16
"c:\Users\linC\app\programming\C++ Project\HyperChat\UnitTest\TestCommon\TestLog.hpp", "C++", 0, 0, 169, 0, 0, 0, 20, 189
"c:\Users\linC\app\programming\C++ Project\HyperChat\UnitTest\TestCommon\TestSerializer.hpp", "C++", 0, 0, 135, 0, 0, 0, 16, 151
"c:\Users\linC\app\programming\C++ Project\HyperChat\UnitTest\TestCommon\TestThreadPool.hpp", "C++", 0, 0, 75, 0, 0, 0, 10, 85
"c:\Users\linC\app\programming\C++ Project\HyperChat\UnitTest\TestServer\TestAsyncTcpServer.hpp", "C++", 0, 0, 98, 0, 0, 0, 21, 119
"c:\Users\linC\app\programming\C++ Project\HyperChat\UnitTest\TestServer\TestChatService.hpp", "C++", 0, 0, 6, 0, 0, 0, 1, 7
"c:\Users\linC\app\programming\C++ Project\HyperChat\UnitTest\TestServer\TestIoContextPool.hpp", "C++", 0, 0, 55, 0, 0, 0, 12, 67
"c:\Users\linC\app\programming\C++ Project\HyperChat\vcpkg.json", "JSON", 5, 0, 0, 0, 0, 0, 1, 6
"Total", "-", 27, 123, 2694, 42, 3, 28, 453, 3370