"filename", "language", "CMake", "C++", "comment", "blank", "total"
"c:\Users\linC\app\programming\C++ Project\HyperChat\ChatServer\CmakeLists.txt", "CMake", 9, 0, 0, 3, 12
"c:\Users\linC\app\programming\C++ Project\HyperChat\ChatServer\RunServer.cpp", "C++", 0, 35, 0, 3, 38
"c:\Users\linC\app\programming\C++ Project\HyperChat\ChatServer\entity\ChatRoom.h", "C++", 0, 15, 0, 2, 17
"c:\Users\linC\app\programming\C++ Project\HyperChat\ChatServer\entity\User.hpp", "C++", 0, 8, 0, 2, 10
"c:\Users\linC\app\programming\C++ Project\HyperChat\ChatServer\include\ChatServer.h", "C++", 0, 32, 0, 5, 37
"c:\Users\linC\app\programming\C++ Project\HyperChat\ChatServer\include\ChatService.h", "C++", 0, 19, 0, 4, 23
"c:\Users\linC\app\programming\C++ Project\HyperChat\ChatServer\include\Session.h", "C++", 0, 34, 0, 8, 42
"c:\Users\linC\app\programming\C++ Project\HyperChat\ChatServer\src\ChatServer.cpp", "C++", 0, 67, 0, 7, 74
"c:\Users\linC\app\programming\C++ Project\HyperChat\ChatServer\src\ChatService.cpp", "C++", 0, 23, 0, 6, 29
"c:\Users\linC\app\programming\C++ Project\HyperChat\ChatServer\src\Session.cpp", "C++", 0, 91, 0, 9, 100
"c:\Users\linC\app\programming\C++ Project\HyperChat\ChatServer\utils\IdGenerator.hpp", "C++", 0, 8, 0, 1, 9
"Total", "-", 9, 332, 0, 50, 391